Original Order,Town,Year,Call Reason,Self,Disp,Total,Avg._Arrive,Avg._Time_@_Scene,Note
1,Leverett,2018,209A SERVICE,2,1,3,8.28,2.98,
2,Leverett,2018,209A VIOLATION,0,1,1,2.33,41.53,
3,Leverett,2018,ABANDONED 911 CALL,0,6,6,9.45,3.37,
4,Leverett,2018,911 CALL,0,17,17,4.25,9.27,
5,Leverett,2018,911 HANG UP,0,3,3,4.36,6.82,
6,Leverett,2018,911 MIS DIAL,0,6,6,11.66,5.6,
7,Leverett,2018,ABANDONED MV,1,1,2,0,2.75,
8,Leverett,2018,ADMINISTRATIVE,51,2,53,0.32,55.6,
9,Leverett,2018,ALARM BURGLAR OR HOLDUP,3,50,53,6.24,10.6,
10,Leverett,2018,EMS ALARM - LIFELINE ACTIVATED,0,9,9,2.26,16.51,
11,Leverett,2018,FIRE ALARM,0,16,16,5.6,22.24,
12,Leverett,2018,ANIMAL COMPLAINT,2,31,33,7.6,11.68,
13,Leverett,2018,ASSIST CITIZEN,4,1,5,5.92,57.38,
14,Leverett,2018,ASSIST OTHER AGENCY,7,2,9,9.1,39.06,
15,Leverett,2018,ASSAULT,0,1,1,16.44,137.39,
16,Leverett,2018,ARTICLES RECOVERED,0,6,6,4.64,2.71,
17,Leverett,2018,BREAKING & ENTERING AUTO,0,1,1,0,0,
18,Leverett,2018,BREAKING AND ENTERING,0,1,1,6.23,12.26,
19,Leverett,2018,BREAKING AND ENTERING PAST,1,2,3,8.01,28.09,
20,Leverett,2018,BE ON THE LOOK OUT,0,1,1,0.93,5.33,
21,Leverett,2018,BUILDING/LOCATION CHECK,136,5,141,11.23,6.32,
22,Leverett,2018,CHIMNEY FIRE,0,4,4,3.2,40.4,
23,Leverett,2018,CHECK WELFARE,3,11,14,5.13,15.3,
24,Leverett,2018,Civil Issue,1,0,1,0,0.73,
25,Leverett,2018,CRUISER MAINTENANCE,15,0,15,0,35.98,
26,Leverett,2018,CARBON MONOXIDE HAZARD,0,5,5,7.3,17.77,
27,Leverett,2018,COMMUNITY POLICING,18,0,18,0,47.14,
28,Leverett,2018,COMPLAINT,1,2,3,4.8,29.23,
29,Leverett,2018,COURT,2,0,2,0,69.01,
30,Leverett,2018,Car vs. Deer,0,5,5,19.83,24.53,
31,Leverett,2018,DISTURBANCE,0,2,2,7.6,60.05,
32,Leverett,2018,DISABLED MV,19,10,29,7.1,19.38,
33,Leverett,2018,Drill/Testing,4,0,4,2.23,69.67,
34,Leverett,2018,ESCORT/TRANSPORT,1,0,1,0,23.18,
35,Leverett,2018,FIREARMS LICENSING,7,0,7,0,44.17,
36,Leverett,2018,"FIRE, BRUSH FIRE",0,1,1,3.53,35.98,
37,Leverett,2018,"FIRE, OTHER NON-SPECIFIC",0,4,4,5.86,30.47,
38,Leverett,2018,"FIRE, VEHICLE FIRE",0,1,1,3.45,56.45,
39,Leverett,2018,"FIRE, FIRE WORKS",0,1,1,0,0,
40,Leverett,2018,FOLLOW UP INVESTIGATION,10,2,12,26.03,46.57,
41,Leverett,2018,FRAUD/SCAM,1,3,4,9.77,11.53,
42,Leverett,2018,GAS LEAK,0,1,1,7.93,24.15,
43,Leverett,2018,GENERAL INFO,0,3,3,0,0,
44,Leverett,2018,HARASSMENT,1,0,1,0,7.5,
45,Leverett,2018,ILLEGAL BURN,0,3,3,8.42,11.78,
46,Leverett,2018,INVESTIGATION,16,1,17,0,16.74,
47,Leverett,2018,LARCENY,0,2,2,3.46,13.06,
48,Leverett,2018,"LINE DOWN, POWER, PHONE OR CABL",2,6,8,9.53,37.93,
49,Leverett,2018,LOCKOUT,1,1,2,0,13.75,
50,Leverett,2018,MEDICAL EMERGENCY,0,85,85,5.73,23.51,
51,Leverett,2018,MISCELLANEOUS,3,5,8,4.47,8.88,
52,Leverett,2018,MOTOR VEHICLE ACCIDENT NO INJU,3,37,40,6.37,32.58,
53,Leverett,2018,MOTOR VEHICLE COMPLAINT,1,21,22,8.94,11.6,
54,Leverett,2018,MOTOR VEHICLE ACCIDE W/INJURY,0,3,3,21.16,88.78,
55,Leverett,2018,MOTOR VEHICLE - STOLEN,0,2,2,14.97,20.13,
56,Leverett,2018,MOTOR VEHICLE VIOLATION,559,3,562,1.02,8.76,
57,Leverett,2018,NOISE COMPLAINT,0,1,1,0,0,
58,Leverett,2018,NOTIFICATION,0,5,5,12.82,38.49,
59,Leverett,2018,ODOR INVESTIGATION,0,3,3,7.78,20.08,
60,Leverett,2018,OFFICER WANTED,1,10,11,21.96,36.86,
61,Leverett,2018,PAPERWORK SERVICE,37,1,38,2.92,4.45,
62,Leverett,2018,ANNOYING PHONE CALLS,0,2,2,11.25,12.08,
63,Leverett,2018,PATROL AREA,104,0,104,0.28,7.86,
64,Leverett,2018,RADAR/TRAFFIC ENFORCEMENT,265,1,266,1.85,26.16,
65,Leverett,2018,ROLLING 9,13,4,17,0,10.21,
66,Leverett,2018,ROLLING Q2-1,1,0,1,0,7.67,
67,Leverett,2018,SAFETY HAZARD,5,15,20,16.84,21.67,
68,Leverett,2018,Section 12,0,1,1,15.34,20.59,
69,Leverett,2018,SERVICE CALL,3,3,6,3.13,48.6,
70,Leverett,2018,SHOPLIFTING,0,1,1,11.87,31.77,
71,Leverett,2018,SHOTS FIRED,0,4,4,11.03,13.24,
72,Leverett,2018,SMOKE INVESTIGATION,0,2,2,28,15.75,
73,Leverett,2018,SUSPICIOUS PERSON,1,6,7,5.4,24.8,
74,Leverett,2018,SUSPICIOUS ACTIVITY,0,2,2,5.45,9.08,
75,Leverett,2018,SUSPICIOUS VEHICLE,8,3,11,7.59,17.21,
76,Leverett,2018,THREAT,0,2,2,52.9,20.15,
77,Leverett,2018,TRAFFIC HAZARD,5,14,19,8.25,31.67,
78,Leverett,2018,TRAFFIC CONTROL,6,0,6,0,25.71,
79,Leverett,2018,TRESPASS,0,1,1,6.43,11.62,
80,Leverett,2018,UNWANTED PERSON,1,1,2,0,17.22,
81,Leverett,2018,VANDALISM,3,1,4,0,10.08,
82,Leverett,2018,SERVE WARRANT,0,1,1,14.93,46.28,
83,Leverett,2019,209A SERVICE,0,1,1,2.26,4.17,
84,Leverett,2019,ABANDONED 911 CALL,0,3,3,10.79,8.06,
85,Leverett,2019,911 CALL,0,24,24,10.78,6.58,
86,Leverett,2019,911 HANG UP,0,6,6,13.52,11.94,
87,Leverett,2019,911 MIS DIAL,0,3,3,6.81,4.9,
88,Leverett,2019,911 Text to 911,0,1,1,0,0,
89,Leverett,2019,ADMINISTRATIVE,296,0,296,1.51,57.2,
90,Leverett,2019,ALARM BURGLAR OR HOLDUP,0,63,63,6.33,9.86,
91,Leverett,2019,EMS ALARM - LIFELINE ACTIVATED,0,4,4,6.55,11.97,
92,Leverett,2019,FIRE ALARM,0,13,13,4.03,15.49,
93,Leverett,2019,ANIMAL COMPLAINT,10,21,31,10.88,12.97,
94,Leverett,2019,ASSIST CITIZEN,18,4,22,4.58,8.82,
95,Leverett,2019,ASSIST OTHER AGENCY,5,5,10,2.37,27.62,
96,Leverett,2019,ARTICLES LOST,1,3,4,0,3.38,
97,Leverett,2019,ARTICLES RECOVERED,10,1,11,12.53,8.32,
98,Leverett,2019,BREAKING & ENTERING PAST,1,1,2,2.72,31.51,
99,Leverett,2019,BE ON THE LOOK OUT,1,0,1,0.1,3.47,
100,Leverett,2019,BUILDING/LOCATION CHECK,595,7,602,8.17,3.47,
101,Leverett,2019,CHIMNEY FIRE,0,2,2,3.97,20.78,
102,Leverett,2019,CHECK WELFARE,3,21,24,9.66,15.74,
103,Leverett,2019,CRUISER MAINTENANCE,74,2,76,0,29.51,
104,Leverett,2019,CARBON MONOXIDE HAZARD,0,7,7,3.07,15.41,
105,Leverett,2019,COMMUNITY POLICING,39,0,39,0,28.77,
106,Leverett,2019,COMPLAINT,1,5,6,11.71,2.67,
107,Leverett,2019,COURT,4,0,4,0,68.9,
108,Leverett,2019,Car vs. Deer,2,9,11,5.08,16.04,
109,Leverett,2019,DEATH,1,0,1,0,5.97,
110,Leverett,2019,DISTURBANCE,0,6,6,12.59,20.73,
111,Leverett,2019,DISABLED MV,14,9,23,9.36,22.71,
112,Leverett,2019,DOMESTIC,0,1,1,9.26,239.2,
113,Leverett,2019,Drill/Testing,5,1,6,0,68.1,
114,Leverett,2019,DETAIL REQUEST,0,2,2,0,0,
115,Leverett,2019,FIREARMS LICENSING,60,0,60,0,29.8,
116,Leverett,2019,BRUSH FIRE,0,2,2,1.41,61.48,
117,Leverett,2019,"FIRE, OTHER NON-SPECIFIC",0,2,2,4.23,95.27,
118,Leverett,2019,FIRE WORKS,0,1,1,0,0,
119,Leverett,2019,FOLLOW UP INVESTIGATION,20,1,21,3.13,12.63,
120,Leverett,2019,FRAUD/SCAM,1,2,3,8.2,15.71,
121,Leverett,2019,GAS LEAK,0,1,1,0,0,
122,Leverett,2019,GENERAL INFO,0,10,10,0,0,
123,Leverett,2019,ILLEGAL BURN,0,1,1,1.57,26.63,
124,Leverett,2019,ILLEGAL DUMPING,2,0,2,0,4.48,
125,Leverett,2019,INVESTIGATION,1,2,3,2.16,79.06,
126,Leverett,2019,LARCENY,2,4,6,7.78,40.37,
127,Leverett,2019,"LINE DOWN, POWER,PHONE OR CABL",1,19,20,8.59,64.17,
128,Leverett,2019,LOCKOUT,2,1,3,0.05,15.76,
129,Leverett,2019,MEDICAL EMERGENCY,0,66,66,6.67,30.97,
130,Leverett,2019,MISSING PERSON,0,1,1,0.88,23.06,
131,Leverett,2019,MISCELLANEOUS,24,4,28,0,7.85,
132,Leverett,2019,MOTOR VEHICLE ACCIDENT NO INJU,5,21,26,6.32,43.04,
133,Leverett,2019,MOTOR VEHICLE COMPLAINT,4,9,13,2.27,5.6,
134,Leverett,2019,MOTOR VEHICLE ACCIDE W/INJURY,0,2,2,8.76,60.64,
135,Leverett,2019,MOTOR VEHICLE - STOLEN,0,1,1,0,0,
136,Leverett,2019,MOTOR VEHICLE VIOLATION,919,2,921,5.16,7.75,
137,Leverett,2019,NOISE COMPLAINT,0,1,1,0,0,
138,Leverett,2019,NOTIFICATION,2,8,10,7.43,5.69,
139,Leverett,2019,ODOR INVESTIGATION,0,1,1,0,0,
140,Leverett,2019,OFFICER WANTED,2,17,19,9.16,21.25,
141,Leverett,2019,PAPERWORK SERVICE,71,0,71,0,4.8,
142,Leverett,2019,PATROL AREA,267,0,267,0,5.06,
143,Leverett,2019,POWER OUTAGE/FAILURE,0,1,1,0,0,
144,Leverett,2019,RADAR/TRAFFIC ENFORCEMENT,920,0,920,1.87,28.61,
145,Leverett,2019,ROLLING 9,4,1,5,0,3.1,
146,Leverett,2019,SAFETY HAZARD,4,17,21,12.9,15.57,
147,Leverett,2019,SERVICE CALL,2,6,8,5.32,14.91,
148,Leverett,2019,SHOTS FIRED,0,1,1,3.07,5.62,
149,Leverett,2019,SUMMONS SERVICE,1,0,1,0,6.75,
150,Leverett,2019,SUSPICIOUS PERSON,1,2,3,0,23.4,
151,Leverett,2019,SUSPICIOUS ACTIVITY,2,1,3,0,9.53,
152,Leverett,2019,SUSPICIOUS VEHICLE,2,6,8,8.43,33.37,
153,Leverett,2019,THREAT,0,1,1,3.62,29.27,
154,Leverett,2019,TRAFFIC HAZARD,5,24,29,6.36,19.98,
155,Leverett,2019,TRAFFIC CONTROL,69,0,69,0,26.64,
156,Leverett,2019,TRESPASS,0,3,3,5.11,11.62,
157,Leverett,2019,UNWANTED PERSON,1,4,5,2.13,54.12,
158,Leverett,2019,SERVE WARRANT,3,0,3,0,20.86,
159,Leverett,2020,209A SERVICE,1,1,2,19.36,6.74,
160,Leverett,2020,ABANDONED 911 CALL,0,7,7,4.46,22.29,
161,Leverett,2020,911 CALL,0,18,18,8.63,10.18,
162,Leverett,2020,911 HANG UP,0,4,4,13.46,5.96,
163,Leverett,2020,911 MIS DIAL,0,12,12,6.72,2.82,
164,Leverett,2020,ABANDONED MV,1,2,3,15.47,21.14,
165,Leverett,2020,ADMINISTRATIVE,89,1,90,1.55,72.8,
166,Leverett,2020,ALARM BURGLAR OR HOLDUP,0,25,25,7.37,6.46,
167,Leverett,2020,EMS ALARM - LIFELINE ACTIVATED,0,5,5,4.7,4.42,
168,Leverett,2020,FIRE ALARM,0,6,6,11.08,26.71,
169,Leverett,2020,ANIMAL COMPLAINT,15,48,63,9.21,19.57,
170,Leverett,2020,ASSIST CITIZEN,25,16,41,3.01,18.85,
171,Leverett,2020,ASSIST OTHER AGENCY,8,8,16,3.12,21.77,
172,Leverett,2020,ARTICLES LOST,1,0,1,0,5.27,
173,Leverett,2020,ARTICLES RECOVERED,4,2,6,0,10.47,
174,Leverett,2020,BUILDING/LOCATION CHECK,536,7,543,0,2.79,
175,Leverett,2020,CHECK WELFARE,5,15,20,10.43,21.46,
176,Leverett,2020,Civil Issue,1,1,2,0,32.3,
177,Leverett,2020,CRUISER MAINTENANCE,146,4,150,0,12.57,
178,Leverett,2020,CARBON MONOXIDE HAZARD,0,4,4,5.26,32.29,
179,Leverett,2020,COMMUNITY POLICING,65,3,68,0.14,19.14,
180,Leverett,2020,COMPLAINT,2,13,15,17,24.49,
181,Leverett,2020,COURT,3,0,3,0,45.43,
182,Leverett,2020,Car vs. Deer,1,10,11,7.03,14.31,
183,Leverett,2020,DISTURBANCE,1,1,2,11.2,55.55,
184,Leverett,2020,DISABLED MV,12,2,14,0.96,33.96,
185,Leverett,2020,DOMESTIC,0,1,1,11.63,126.92,
186,Leverett,2020,DETAIL REQUEST,0,5,5,2.75,41.48,
187,Leverett,2020,ESCORT/TRANSPORT,2,1,3,0,31.66,
188,Leverett,2020,FIREARMS LICENSING,33,4,37,0,37.62,
189,Leverett,2020,BRUSH FIRE,0,1,1,9.73,178.7,
190,Leverett,2020,STRUCTURE FIRE,0,1,1,8.07,235.46,
191,Leverett,2020,"FIRE, OTHER NON-SPECIFIC",1,3,4,0.58,77.83,
192,Leverett,2020,VEHICLE FIRE,0,1,1,0,0,
193,Leverett,2020,FIRE WORKS,0,3,3,5.93,7.72,
194,Leverett,2020,FOLLOW UP INVESTIGATION,17,1,18,0,30.55,
195,Leverett,2020,FRAUD/SCAM,6,15,21,19.61,13.78,
196,Leverett,2020,GAS LEAK,0,2,2,6.3,25.33,
197,Leverett,2020,GENERAL INFO,1,21,22,0,0,
198,Leverett,2020,HARASSMENT,0,3,3,7.41,19.33,
199,Leverett,2020,INVESTIGATION,8,5,13,3.41,22.75,
200,Leverett,2020,KEEP THE PEACE,3,1,4,5.14,29.19,
201,Leverett,2020,LARCENY,3,3,6,9.61,19.36,
202,Leverett,2020,LINE DOWN POWER PHONE OR CABL,2,30,32,5.55,36.73,
203,Leverett,2020,LOCKOUT,0,1,1,19.18,0.75,
204,Leverett,2020,MEDICAL EMERGENCY,2,67,69,5.04,27.76,
205,Leverett,2020,MISSING PERSON,1,0,1,0,36.15,
206,Leverett,2020,MISCELLANEOUS,42,6,48,8.08,7.59,
207,Leverett,2020,MOTOR VEHICLE ACCIDENT NO INJU,2,17,19,7.61,56.23,
208,Leverett,2020,MOTOR VEHICLE COMPLAINT,3,14,17,7.82,61.62,
209,Leverett,2020,MOTOR VEHICLE ACCIDE W/INJURY,0,5,5,11.25,60.97,
210,Leverett,2020,MOTOR VEHICLE VIOLATION,732,8,740,3.61,8.04,
211,Leverett,2020,NOISE COMPLAINT,3,3,6,4.35,15.48,
212,Leverett,2020,NOTIFICATION,0,3,3,9.52,5.83,
213,Leverett,2020,ODOR INVESTIGATION,0,4,4,11.22,33.02,
214,Leverett,2020,OFFICER WANTED,1,13,14,10.17,38.94,
215,Leverett,2020,PAPERWORK SERVICE,60,3,63,0.05,5.51,
216,Leverett,2020,PATROL AREA,157,0,157,1.23,3.51,
217,Leverett,2020,RADAR/TRAFFIC ENFORCEMENT,435,2,437,0.79,32.29,
218,Leverett,2020,REPOSSESSION,0,1,1,0,0,
219,Leverett,2020,RESCUE CALL,0,1,1,1.83,99.33,
220,Leverett,2020,ROLLING 9,3,1,4,0,8.07,
221,Leverett,2020,SAFETY HAZARD,2,12,14,7.99,46.72,
222,Leverett,2020,SERVICE CALL,0,8,8,7.29,44.44,
223,Leverett,2020,SHOTS FIRED,0,6,6,5.25,26.2,
224,Leverett,2020,SMOKE INVESTIGATION,0,3,3,4.52,34.51,
225,Leverett,2020,SEX OFFENDER REGISTRATION,1,0,1,0,10.63,
226,Leverett,2020,SUSPICIOUS PERSON,0,1,1,3.8,38.04,
227,Leverett,2020,SUSPICIOUS PACKAGE,2,0,2,9.08,48.91,
228,Leverett,2020,SUSPICIOUS ACTIVITY,5,3,8,17.92,10.72,
229,Leverett,2020,SUSPICIOUS VEHICLE,14,5,19,5.55,19.31,
230,Leverett,2020,THREAT,1,2,3,8.83,24.13,
231,Leverett,2020,TRAFFIC HAZARD,21,12,33,6.85,8.28,
232,Leverett,2020,TRAFFIC CONTROL,77,1,78,0.5,37.43,
233,Leverett,2020,TRESPASS,1,0,1,0,9.52,
234,Leverett,2020,UNWANTED PERSON,0,3,3,6.57,106.38,
235,Leverett,2020,VANDALISM,3,2,5,35.55,24.84,
236,Leverett,2021,209A SERVICE,6,0,6,0,6.24,
237,Leverett,2021,209A VIOLATION,1,0,1,0,36,
238,Leverett,2021,ABANDONED 911 CALL,0,2,2,9.1,2.92,
239,Leverett,2021,911 CALL,0,28,28,8.58,5.17,
240,Leverett,2021,911 HANG UP,0,9,9,14.23,26.03,
241,Leverett,2021,911 MIS DIAL,0,10,10,6.53,4.9,
242,Leverett,2021,ABANDONED MV,0,1,1,0,20.73,
243,Leverett,2021,ADMINISTRATIVE,69,0,69,0,40.3,
244,Leverett,2021,ALARM BURGLAR OR HOLDUP,0,35,35,9.17,5.06,
245,Leverett,2021,EMS ALARM - LIFELINE ACTIVATED,0,4,4,5.51,10.23,
246,Leverett,2021,FIRE ALARM,0,12,12,9.44,13.82,
247,Leverett,2021,ANIMAL COMPLAINT,16,34,50,7.02,16.79,
248,Leverett,2021,ASSIST CITIZEN,36,24,60,4.31,23.09,
249,Leverett,2021,ASSIST OTHER AGENCY,14,11,25,2.94,31.51,
250,Leverett,2021,ASSAULT,0,1,1,8.47,15.82,
251,Leverett,2021,ARTICLES LOST,0,1,1,0,0,
252,Leverett,2021,ARTICLES RECOVERED,4,4,8,19.18,6.67,
253,Leverett,2021,BREAKING & ENTERING AUTO,0,1,1,5.74,18.57,
254,Leverett,2021,BUILDING/LOCATION CHECK,598,10,608,3.88,2.13,
255,Leverett,2021,BYLAW VIOLATION,1,0,1,0,0,
256,Leverett,2021,CHIMNEY FIRE,0,5,5,4.95,34.98,
257,Leverett,2021,CHECK WELFARE,6,16,22,7.87,24.56,
258,Leverett,2021,Civil Issue,1,1,2,10.48,14.86,
259,Leverett,2021,CRUISER MAINTENANCE,51,0,51,0.06,10.68,
260,Leverett,2021,CARBON MONOXIDE HAZARD,0,2,2,7.88,1.43,
261,Leverett,2021,COMMUNITY POLICING,50,3,53,0,33.86,
262,Leverett,2021,COMPLAINT,1,5,6,13.02,15.09,
263,Leverett,2021,COURT,2,0,2,0,49.28,
264,Leverett,2021,CUSTODY ISSUE,0,1,1,0,0,
265,Leverett,2021,Car vs. Deer,0,8,8,10.37,14.89,
266,Leverett,2021,Paid Detail,0,1,1,0,0,
267,Leverett,2021,DISTURBANCE,2,2,4,5.99,12.33,
268,Leverett,2021,DISABLED MV,20,12,32,7,25.33,
269,Leverett,2021,Drill/Testing,0,3,3,0,0,
270,Leverett,2021,DETAIL REQUEST,0,7,7,7.38,3.81,
271,Leverett,2021,ESCORT/TRANSPORT,5,1,6,0,9.79,
272,Leverett,2021,FIREARMS LICENSING,59,4,63,0.68,11.72,
273,Leverett,2021,BRUSH FIRE,0,3,3,4.29,60.72,
274,Leverett,2021,FIRE OTHER NON-SPECIFIC,0,5,5,7.58,13.23,
275,Leverett,2021,VEHICLE FIRE,0,1,1,6.53,16.5,
276,Leverett,2021,FIRE WORKS,0,1,1,8.15,14.38,
277,Leverett,2021,FOLLOW UP INVESTIGATION,13,7,20,32.32,33.49,
278,Leverett,2021,FRAUD/SCAM,2,11,13,12.49,13.86,
279,Leverett,2021,GENERAL INFO,0,20,20,0,0,
280,Leverett,2021,HARASSMENT,1,2,3,0.05,19.15,
281,Leverett,2021,ILLEGAL BURN,0,2,2,11.46,9.06,
282,Leverett,2021,ILLEGAL DUMPING,2,1,3,6.12,4.24,
283,Leverett,2021,INVESTIGATION,13,7,20,0.82,32.71,
284,Leverett,2021,KEEP THE PEACE,0,2,2,2.78,7.3,
285,Leverett,2021,LARCENY,3,7,10,16.61,23.92,
286,Leverett,2021,LINE DOWN POWER PHONE OR CABL,1,12,13,14.12,34.72,
287,Leverett,2021,LOCKOUT,1,1,2,6.57,8.58,
288,Leverett,2021,MEDICAL EMERGENCY,0,84,84,7.98,24.68,
289,Leverett,2021,MISCELLANEOUS,5,4,9,0,80.37,
290,Leverett,2021,MOTOR VEHICLE ACCIDENT NO INJU,2,19,21,6.73,57.43,
291,Leverett,2021,MOTOR VEHICLE COMPLAINT,3,21,24,10.53,13.2,
292,Leverett,2021,MOTOR VEHICLE ACCIDE W/INJURY,0,5,5,7.01,74.12,
293,Leverett,2021,MOTOR VEHICLE VIOLATION,569,1,570,2.74,8.87,
294,Leverett,2021,NOISE COMPLAINT,1,4,5,9,24.88,
295,Leverett,2021,NOTIFICATION,2,11,13,8.7,21.41,
296,Leverett,2021,OPEN DOOR,1,0,1,0,12.42,
297,Leverett,2021,ODOR INVESTIGATION,0,4,4,4.8,7.76,
298,Leverett,2021,OFFICER WANTED,0,17,17,8.53,36.24,
299,Leverett,2021,PAPERWORK SERVICE,28,3,31,0.03,4.97,
300,Leverett,2021,PARKING COMPLAINT,1,0,1,0,6.27,
301,Leverett,2021,PATROL AREA,17,1,18,0,41.37,
302,Leverett,2021,RADAR/TRAFFIC ENFORCEMENT,241,1,242,1.04,30.52,
303,Leverett,2021,RESCUE CALL,1,0,1,0,89.87,
304,Leverett,2021,ROLLING 9,2,0,2,0,6.43,
305,Leverett,2021,SAFETY HAZARD,0,6,6,10.83,37.82,
306,Leverett,2021,SEARCH,2,2,4,0.12,161.54,
307,Leverett,2021,Section 12,0,1,1,18.53,0.48,
308,Leverett,2021,SERVICE CALL,0,6,6,4.78,19.99,
309,Leverett,2021,SHOTS FIRED,0,1,1,5.72,20.23,
310,Leverett,2021,SMOKE INVESTIGATION,0,5,5,9.04,7.23,
311,Leverett,2021,SEX OFFENDER REGISTRATION,3,0,3,0,21.62,
312,Leverett,2021,SUMMONS SERVICE,4,0,4,0,2.8,
313,Leverett,2021,SUSPICIOUS PERSON,0,3,3,7.9,43.28,
314,Leverett,2021,SUSPICIOUS ACTIVITY,1,5,6,14.42,27.69,
315,Leverett,2021,SUSPICIOUS VEHICLE,2,9,11,5.53,7.4,
316,Leverett,2021,TRAFFIC HAZARD,15,15,30,8.51,15.85,
317,Leverett,2021,TRAFFIC CONTROL,15,1,16,0.22,17.15,
318,Leverett,2021,TRESPASS,0,2,2,6.58,15.27,
319,Leverett,2021,UNWANTED PERSON,0,2,2,20.75,35.68,
320,Leverett,2021,VANDALISM,4,4,8,6.39,10.34,
321,Leverett,2021,SERVE WARRANT,1,0,1,0,5.12,
322,Leverett,2022,209A SERVICE,2,1,3,0.31,12.11,
323,Leverett,2022,ABANDONED 911 CALL,0,6,6,5.62,30.02,
324,Leverett,2022,911 CALL,0,27,27,10.4,6.3,
325,Leverett,2022,911 HANG UP,0,11,11,9.15,21.6,
326,Leverett,2022,911 MIS DIAL,0,11,11,10.36,2.54,
327,Leverett,2022,ABANDONED MV,1,0,1,0,0,
328,Leverett,2022,ADMINISTRATIVE,223,11,234,0,80.69,
329,Leverett,2022,ALARM BURGLAR OR HOLDUP,0,32,32,8.43,9.14,
330,Leverett,2022,EMS ALARM - LIFELINE ACTIVATED,0,8,8,8.54,10.46,
331,Leverett,2022,FIRE ALARM,0,10,10,11.47,37.14,
332,Leverett,2022,ANIMAL COMPLAINT,22,60,82,11.03,13.99,
333,Leverett,2022,ASSIST CITIZEN,51,48,99,9.63,11.5,
334,Leverett,2022,ASSIST OTHER AGENCY,13,17,30,10.54,17.3,
335,Leverett,2022,ASSAULT,0,1,1,11.68,65.02,
336,Leverett,2022,ARTICLES LOST,0,4,4,0,0,
337,Leverett,2022,ARTICLES RECOVERED,2,5,7,0,28.04,
338,Leverett,2022,BREAKING AND ENTERING,0,1,1,6.28,11.03,
339,Leverett,2022,BREAKING & ENTERING PAST,0,1,1,0,0,
340,Leverett,2022,BE ON THE LOOK OUT,0,1,1,0,0,
341,Leverett,2022,BUILDING/LOCATION CHECK,707,3,710,0,3.65,
342,Leverett,2022,CHIMNEY FIRE,0,2,2,4.06,30.99,
343,Leverett,2022,CHECK WELFARE,6,20,26,8.02,27.42,
344,Leverett,2022,Civil Issue,1,0,1,0,5.05,
345,Leverett,2022,CRUISER MAINTENANCE,43,0,43,0,39.63,
346,Leverett,2022,CARBON MONOXIDE HAZARD,0,3,3,10.13,12.5,
347,Leverett,2022,COMMUNITY POLICING,110,6,116,0.08,28.7,
348,Leverett,2022,COMPLAINT,0,5,5,3.8,7.4,
349,Leverett,2022,CSO FOLLOW UP,1,0,1,0,119.23,
350,Leverett,2022,CSO OUTREACH,1,1,2,24.84,41.31,
351,Leverett,2022,COURT,2,2,4,29.83,18.88,
352,Leverett,2022,Car vs. Deer,0,12,12,8.36,12.54,
353,Leverett,2022,DISTURBANCE,0,3,3,8.64,26.64,
354,Leverett,2022,DISABLED MV,18,21,39,4.18,17.17,
355,Leverett,2022,DRUNK,0,1,1,0.06,17.43,
356,Leverett,2022,Drill/Testing,3,2,5,0.37,30.15,
357,Leverett,2022,DETAIL REQUEST,0,6,6,15.23,0.19,
358,Leverett,2022,ESCORT/TRANSPORT,6,0,6,0,35.98,
359,Leverett,2022,FIREARMS LICENSING,57,8,65,0,15.61,
360,Leverett,2022,STRUCTURE FIRE,0,1,1,8.63,41.23,
361,Leverett,2022,FIRE OTHER NON-SPECIFIC,0,4,4,9.68,39.94,
362,Leverett,2022,VEHICLE FIRE,0,1,1,2.63,52.28,
363,Leverett,2022,FIRE WORKS,0,2,2,8.26,12.04,
364,Leverett,2022,FOLLOW UP INVESTIGATION,27,14,41,1.64,20.2,
365,Leverett,2022,FRAUD/SCAM,1,5,6,0.17,31.03,
366,Leverett,2022,GAS LEAK,0,1,1,10.23,12.25,
367,Leverett,2022,GENERAL INFO,0,22,22,0,0,
368,Leverett,2022,HARASSMENT,1,5,6,25.18,27.18,
369,Leverett,2022,HIT AND RUN,1,0,1,0,9.07,
370,Leverett,2022,ILLEGAL BURN,1,1,2,0,16.13,
371,Leverett,2022,ILLEGAL DUMPING,2,0,2,0,2.28,
372,Leverett,2022,INVESTIGATION,9,1,10,0.08,24.31,
373,Leverett,2022,JUVENILE OFFENSES,0,1,1,0,0,
374,Leverett,2022,KEEP THE PEACE,0,1,1,2.58,40.1,
375,Leverett,2022,LARCENY,2,1,3,0,2.47,
376,Leverett,2022,"LINE DOWN, POWER, PHONE OR CABL",1,15,16,10.38,96.93,
377,Leverett,2022,LOCKOUT,0,3,3,8.74,22.42,
378,Leverett,2022,MEDICAL EMERGENCY,0,93,93,5.41,29.16,
379,Leverett,2022,MISSING PERSON,0,3,3,3.2,4.32,
380,Leverett,2022,MISCELLANEOUS,7,4,11,10.63,16.41,
381,Leverett,2022,MOTOR VEHICLE ACCIDENT NO INJU,4,25,29,10.26,49.98,
382,Leverett,2022,MOTOR VEHICLE COMPLAINT,0,17,17,8.07,9.39,
383,Leverett,2022,MOTOR VEHICLE ACCIDE W/INJURY,0,1,1,2.37,42.15,
384,Leverett,2022,MOTOR VEHICLE VIOLATION,327,0,327,0.03,8.53,
385,Leverett,2022,NOISE COMPLAINT,0,1,1,0,0,
386,Leverett,2022,NOTIFICATION,4,14,18,4.42,1.43,
387,Leverett,2022,OPEN DOOR,1,0,1,0,3.35,
388,Leverett,2022,ODOR INVESTIGATION,0,1,1,2.02,3.62,
389,Leverett,2022,OFFICER WANTED,1,14,15,6.42,44.65,
390,Leverett,2022,PAPERWORK SERVICE,26,2,28,6.52,3.84,
391,Leverett,2022,PATROL AREA,25,0,25,0,39.14,
392,Leverett,2022,RADAR/TRAFFIC ENFORCEMENT,474,1,475,0.83,31.89,
393,Leverett,2022,RAPE,0,1,1,0.12,42.62,
394,Leverett,2022,RUNAWAY,0,1,1,0.76,109.2,
395,Leverett,2022,ROLLING 9,1,0,1,0,1.38,
396,Leverett,2022,SAFETY HAZARD,3,9,12,4.35,10.64,
397,Leverett,2022,Section 12,0,1,1,10.46,9.37,
398,Leverett,2022,SERVICE CALL,1,3,4,0,2.58,
399,Leverett,2022,SHOTS FIRED,1,6,7,7.9,14.74,
400,Leverett,2022,SMOKE INVESTIGATION,0,3,3,4.25,10.45,
401,Leverett,2022,SEX OFFENDER REGISTRATION,5,1,6,0,20.37,
402,Leverett,2022,SCHOOL RESOURCE OFFICER DUTIES,1,0,1,0,4.82,
403,Leverett,2022,SUSPICIOUS PERSON,1,3,4,12.39,7.7,
404,Leverett,2022,SUSPICIOUS ACTIVITY,0,5,5,0,0,
405,Leverett,2022,SUSPICIOUS VEHICLE,5,6,11,7.27,5.41,
406,Leverett,2022,SWATTING,0,2,2,8.27,17.33,
407,Leverett,2022,TRAFFIC HAZARD,9,21,30,6.04,26.88,
408,Leverett,2022,TRAFFIC CONTROL,24,2,26,0.3,19.38,
409,Leverett,2022,TRESPASS,0,1,1,0.75,4.88,
410,Leverett,2022,UNWANTED PERSON,0,2,2,6.33,47.2,
411,Leverett,2022,VANDALISM,0,3,3,6.61,16.61,
412,Leverett,2022,SERVE WARRANT,1,0,1,0,10.1,
413,Wendell,2018,ABANDONED 911 CALL,0,3,3,0,0,
414,Wendell,2018,911 CALL,0,13,13,16.27,5.27,
415,Wendell,2018,911 HANG UP,0,3,3,28.88,1.42,
416,Wendell,2018,911 MIS DIAL,0,2,2,0,0,
417,Wendell,2018,ABANDONED MV,0,1,1,0,0,
418,Wendell,2018,ALARM BURGLAR OR HOLDUP,0,15,15,6.63,5.84,
419,Wendell,2018,EMS ALARM - LIFELINE ACTIVATED,0,2,2,0,0,
420,Wendell,2018,FIRE ALARM,0,8,8,0,0,
421,Wendell,2018,ANIMAL COMPLAINT,0,9,9,0,0,
422,Wendell,2018,ASSIST OTHER AGENCY,0,2,2,0,0,
423,Wendell,2018,BREAKING & ENTERING PAST,0,2,2,0,0,
424,Wendell,2018,CHIMNEY FIRE,0,3,3,0,0,
425,Wendell,2018,CHECK WELFARE,0,8,8,53.62,0.07,
426,Wendell,2018,CARBON MONOXIDE HAZARD,0,1,1,0,0,
427,Wendell,2018,COMPLAINT,0,3,3,0,0,
428,Wendell,2018,DISTURBANCE,0,1,1,1.05,53.55,
429,Wendell,2018,DISABLED MV,0,5,5,20.6,32.23,
430,Wendell,2018,DRUNK,1,0,1,0,10.33,
431,Wendell,2018,FIRE OTHER NON-SPECIFIC,0,4,4,0,0,
432,Wendell,2018,FIRE WORKS,0,1,1,0,0,
433,Wendell,2018,FRAUD/SCAM,0,1,1,0,0,
434,Wendell,2018,HARASSMENT,0,3,3,0,0,
435,Wendell,2018,ILLEGAL BURN,0,2,2,0,0,
436,Wendell,2018,LARCENY,0,2,2,0,0,
437,Wendell,2018,LINE DOWN POWER PHONE OR CABL,1,1,2,0,0,
438,Wendell,2018,LOCKOUT,0,2,2,0,0,
439,Wendell,2018,MEDICAL EMERGENCY,0,33,33,16.5,38.6,
440,Wendell,2018,MISSING PERSON,0,1,1,0,0,
441,Wendell,2018,MISCELLANEOUS,1,1,2,0,4.45,
442,Wendell,2018,MOTOR VEHICLE ACCIDENT NO INJU,1,17,18,12.94,77.29,
443,Wendell,2018,MOTOR VEHICLE COMPLAINT,0,4,4,60.17,0.1,
444,Wendell,2018,MOTOR VEHICLE ACCIDE W/INJURY,0,2,2,12.25,23.02,
445,Wendell,2018,MOTOR VEHICLE VIOLATION,1,1,2,0,277.22,
446,Wendell,2018,NOTIFICATION,0,2,2,0,0,
447,Wendell,2018,OFFICER WANTED,0,6,6,15.95,0.18,
448,Wendell,2018,PAPERWORK SERVICE,0,1,1,0,0,
449,Wendell,2018,RUNAWAY,0,1,1,0,0,
450,Wendell,2018,SAFETY HAZARD,0,7,7,11.25,351.38,
451,Wendell,2018,SERVICE CALL,0,2,2,0,0,
452,Wendell,2018,SHOTS FIRED,0,1,1,0,0,
453,Wendell,2018,SMOKE INVESTIGATION,0,1,1,2.23,17.13,
454,Wendell,2018,SUSPICIOUS PERSON,0,2,2,0,0,
455,Wendell,2018,SUSPICIOUS ACTIVITY,0,2,2,0,0,
456,Wendell,2018,SUICIDE THREAT,0,2,2,2.48,16.2,
457,Wendell,2018,SUSPICIOUS VEHICLE,0,3,3,0,0,
458,Wendell,2018,THREAT,0,2,2,0,0,
459,Wendell,2018,TRAFFIC HAZARD,0,5,5,706.82,102.43,
460,Wendell,2018,VANDALISM,0,1,1,0,0,
461,Wendell,2019,209A SERVICE,0,1,1,0,0,
462,Wendell,2019,209A VIOLATION,0,2,2,0,0,
463,Wendell,2019,ABANDONED 911 CALL,0,9,9,0.03,0,
464,Wendell,2019,911 CALL,0,16,16,14.38,37.58,
465,Wendell,2019,911 HANG UP,0,5,5,0,0,
466,Wendell,2019,911 MIS DIAL,0,6,6,0,0,
467,Wendell,2019,ABANDONED MV,0,1,1,0,0,
468,Wendell,2019,ADMINISTRATIVE,1,0,1,0,0,
469,Wendell,2019,ALARM BURGLAR OR HOLDUP,0,4,4,9.65,11.08,
470,Wendell,2019,EMS ALARM - LIFELINE ACTIVATED,0,3,3,0,0,
471,Wendell,2019,FIRE ALARM,0,8,8,0,0,
472,Wendell,2019,ANIMAL COMPLAINT,0,6,6,10.43,0.15,
473,Wendell,2019,ASSIST CITIZEN,0,1,1,0,0,
474,Wendell,2019,ASSIST OTHER AGENCY,0,1,1,0,0,
475,Wendell,2019,ASSAULT,0,1,1,0,0,
476,Wendell,2019,BREAKING & ENTERING PAST,0,2,2,12.05,15.72,
477,Wendell,2019,CHIMNEY FIRE,0,3,3,0,0,
478,Wendell,2019,CHECK WELFARE,0,14,14,37.26,10.06,
479,Wendell,2019,CARBON MONOXIDE HAZARD,0,3,3,0,0,
480,Wendell,2019,COMPLAINT,0,2,2,16.78,4.62,
481,Wendell,2019,Car vs. Deer,0,4,4,28.4,0.08,
482,Wendell,2019,DEATH,0,1,1,7.84,129.96,
483,Wendell,2019,DISTURBANCE,0,2,2,31.67,43.62,
484,Wendell,2019,DISABLED MV,0,4,4,0,0,
485,Wendell,2019,DOMESTIC,0,1,1,16.06,65.76,
486,Wendell,2019,Drill/Testing,0,2,2,0,0,
487,Wendell,2019,DRUG OFFENSE,0,1,1,0,0,
488,Wendell,2019,DETAIL REQUEST,0,5,5,0,0,
489,Wendell,2019,ESCORT/TRANSPORT,0,1,1,0,0,
490,Wendell,2019,FIGHT,0,1,1,7.93,49.64,
491,Wendell,2019,BRUSH FIRE,0,2,2,0,0,
492,Wendell,2019,FIRE OTHER NON-SPECIFIC,0,1,1,0,0,
493,Wendell,2019,FRAUD/SCAM,0,3,3,0,0,
494,Wendell,2019,GAS LEAK,0,1,1,0,0,
495,Wendell,2019,GENERAL INFO,0,10,10,0,0,
496,Wendell,2019,HARASSMENT,0,2,2,0,0,
497,Wendell,2019,ILLEGAL BURN,0,1,1,0,0,
498,Wendell,2019,ILLEGAL DUMPING,0,1,1,0,0,
499,Wendell,2019,INVESTIGATION,0,1,1,30.83,0.03,
500,Wendell,2019,KEEP THE PEACE,1,1,2,4.83,47.31,
501,Wendell,2019,LARCENY,0,1,1,0,0,
502,Wendell,2019,LINE DOWN POWER PHONE OR CABL,0,12,12,0,0,
503,Wendell,2019,LOCKOUT,0,1,1,11.53,8.78,
504,Wendell,2019,MEDICAL EMERGENCY,0,41,41,31.75,0.05,
505,Wendell,2019,MISCELLANEOUS,0,3,3,0,0,
506,Wendell,2019,MOTOR VEHICLE ACCIDENT NO INJU,0,10,10,23.03,44.65,
507,Wendell,2019,MOTOR VEHICLE COMPLAINT,0,5,5,0,0,
508,Wendell,2019,MOTOR VEHICLE ACCIDE W/INJURY,0,2,2,12.35,56,
509,Wendell,2019,MOTOR VEHICLE VIOLATION,1,0,1,0,3.77,
510,Wendell,2019,NOISE COMPLAINT,0,1,1,0,0,
511,Wendell,2019,NOTIFICATION,0,12,12,38.2,0.13,
512,Wendell,2019,OPEN DOOR,0,1,1,0,0,
513,Wendell,2019,ODOR INVESTIGATION,0,1,1,0,0,
514,Wendell,2019,OFFICER WANTED,0,5,5,0,0,
515,Wendell,2019,PAPERWORK SERVICE,1,0,1,0.3,16,
516,Wendell,2019,REPOSSESSION,0,1,1,0,0,
517,Wendell,2019,SAFETY HAZARD,0,2,2,0,0,
518,Wendell,2019,SERVICE CALL,0,1,1,0,0,
519,Wendell,2019,SHOTS FIRED,0,1,1,0,0,
520,Wendell,2019,SUICIDE COMMITTED,0,1,1,31.38,202.08,
521,Wendell,2019,SUSPICIOUS PERSON,0,2,2,0,0,
522,Wendell,2019,SUICIDE THREAT,0,1,1,0,0,
523,Wendell,2019,SUSPICIOUS VEHICLE,0,2,2,13.63,6.13,
524,Wendell,2019,TRAFFIC HAZARD,0,3,3,0,0,
525,Wendell,2019,TRESPASS,0,3,3,0,0,
526,Wendell,2019,VANDALISM,0,1,1,0,0,
527,Wendell,2019,SERVE WARRANT,0,1,1,0,0,
528,Wendell,2020,209A SERVICE,1,0,1,0,16.68,
529,Wendell,2020,ABANDONED 911 CALL,0,1,1,0,0,
530,Wendell,2020,911 CALL,0,23,23,16.54,0.87,
531,Wendell,2020,911 HANG UP,0,6,6,20.72,2.22,
532,Wendell,2020,911 MIS DIAL,0,2,2,1,0,
533,Wendell,2020,ALARM BURGLAR OR HOLDUP,0,2,2,0,0,
534,Wendell,2020,EMS ALARM - LIFELINE ACTIVATED,0,7,7,0,0,
535,Wendell,2020,FIRE ALARM,0,4,4,0,0,
536,Wendell,2020,ANIMAL COMPLAINT,1,4,5,18.63,29.72,
537,Wendell,2020,ASSIST CITIZEN,1,2,3,0,19.07,
538,Wendell,2020,ASSIST OTHER AGENCY,1,4,5,27.45,47.25,
539,Wendell,2020,BREAKING & ENTERING PAST,0,1,1,0,0,
540,Wendell,2020,BUILDING/LOCATION CHECK,1,0,1,0,1,
541,Wendell,2020,CHIMNEY FIRE,0,1,1,0,0,
542,Wendell,2020,CHECK WELFARE,0,9,9,22.82,20.62,
543,Wendell,2020,CARBON MONOXIDE HAZARD,0,3,3,23.73,7.25,
544,Wendell,2020,COMMUNITY POLICING,0,1,1,0,0,
545,Wendell,2020,COMPLAINT,0,4,4,0,0,
546,Wendell,2020,DEATH,0,2,2,28.43,178.83,
547,Wendell,2020,DISTURBANCE,0,2,2,11.57,98.75,
548,Wendell,2020,DISABLED MV,1,1,2,0,2.93,
549,Wendell,2020,DRUNK,0,1,1,18.48,111.45,
550,Wendell,2020,Drill/Testing,0,1,1,0,0,
551,Wendell,2020,DETAIL REQUEST,0,1,1,0,0,
552,Wendell,2020,EXPLOSION,0,1,1,1.85,16.08,
553,Wendell,2020,FIREARMS LICENSING,0,2,2,0,0,
554,Wendell,2020,BRUSH FIRE,0,3,3,0,0,
555,Wendell,2020,FIRE OTHER NON-SPECIFIC,0,1,1,0,0,
556,Wendell,2020,FIRE WORKS,0,3,3,21.42,4.58,
557,Wendell,2020,FOLLOW UP INVESTIGATION,4,0,4,0,17.98,
558,Wendell,2020,FRAUD/SCAM,1,2,3,57.12,2.65,
559,Wendell,2020,GAS LEAK,0,1,1,21.08,42.35,
560,Wendell,2020,GENERAL INFO,0,11,11,0,0,
561,Wendell,2020,HARASSMENT,0,1,1,0,0,
562,Wendell,2020,ILLEGAL BURN,0,3,3,0,0,
563,Wendell,2020,INVESTIGATION,0,3,3,0,0,
564,Wendell,2020,LARCENY,0,3,3,0,0,
565,Wendell,2020,LINE DOWN POWER PHONE OR CABL,0,19,19,22.68,11.1,
566,Wendell,2020,LOCKOUT,0,2,2,0,0,
567,Wendell,2020,MEDICAL EMERGENCY,1,32,33,16.17,40.58,
568,Wendell,2020,MISSING PERSON,0,5,5,0.03,96.82,
569,Wendell,2020,MISCELLANEOUS,0,2,2,0,0,
570,Wendell,2020,MOTOR VEHICLE ACCIDENT NO INJU,0,15,15,14.95,49.38,
571,Wendell,2020,MOTOR VEHICLE COMPLAINT,0,4,4,0,0,
572,Wendell,2020,MOTOR VEHICLE ACCIDE W/INJURY,0,1,1,23.85,29.2,
573,Wendell,2020,MOTOR VEHICLE RECOVERED,0,1,1,0,0,
574,Wendell,2020,MOTOR VEHICLE VIOLATION,4,0,4,0,39.84,
575,Wendell,2020,NOISE COMPLAINT,0,4,4,0,0,
576,Wendell,2020,NOTIFICATION,0,14,14,0,0,
577,Wendell,2020,OFFICER WANTED,1,6,7,8.3,282.88,
578,Wendell,2020,PAPERWORK SERVICE,13,3,16,16.85,6.51,
579,Wendell,2020,PATROL AREA,1,0,1,0,20.98,
580,Wendell,2020,ROLLING 9,1,0,1,0,1.93,
581,Wendell,2020,SAFETY HAZARD,1,11,12,17.31,65.97,
582,Wendell,2020,Section 12,0,1,1,0,0,
583,Wendell,2020,SERVICE CALL,0,1,1,22.68,32.67,
584,Wendell,2020,SHOTS FIRED,0,3,3,19.34,16.78,
585,Wendell,2020,SMOKE INVESTIGATION,0,2,2,0,0,
586,Wendell,2020,SOLICITING,0,2,2,0,0,
587,Wendell,2020,SEX OFFENDER REGISTRATION,0,4,4,5.43,6.35,
588,Wendell,2020,SUICIDE COMMITTED,0,1,1,11.96,131.84,
589,Wendell,2020,SUSPICIOUS PERSON,1,2,3,13.72,20.97,
590,Wendell,2020,SUSPICIOUS ACTIVITY,1,3,4,15.8,25.37,
591,Wendell,2020,SUSPICIOUS VEHICLE,0,3,3,16.27,0.05,
592,Wendell,2020,THREAT,0,2,2,0,0,
593,Wendell,2020,TRAFFIC HAZARD,0,7,7,0,0,
594,Wendell,2021,209A SERVICE,0,1,1,24.7,36.83,
595,Wendell,2021,ABANDONED 911 CALL,0,3,3,21.32,14.75,
596,Wendell,2021,911 CALL,0,17,17,22.74,4.72,
597,Wendell,2021,911 HANG UP,0,5,5,16.61,7.56,
598,Wendell,2021,911 MIS DIAL,0,7,7,19.73,4.18,
599,Wendell,2021,ABANDONED MV,1,1,2,0,44.18,
600,Wendell,2021,ADMINISTRATIVE,3,0,3,0,36.8,
601,Wendell,2021,ALARM BURGLAR OR HOLDUP,0,3,3,16.58,6.18,
602,Wendell,2021,EMS ALARM - LIFELINE ACTIVATED,0,4,4,0,0,
603,Wendell,2021,FIRE ALARM,0,14,14,12.39,10.91,
604,Wendell,2021,ANIMAL COMPLAINT,4,45,49,12.57,15.96,
605,Wendell,2021,ASSIST CITIZEN,1,2,3,0,9.17,
606,Wendell,2021,ASSIST OTHER AGENCY,5,4,9,3.39,16.85,
607,Wendell,2021,ASSAULT,0,1,1,9.03,64.92,
608,Wendell,2021,ARTICLES RECOVERED,1,0,1,0,0,
609,Wendell,2021,BE ON THE LOOK OUT,0,2,2,0,0,
610,Wendell,2021,BURN/AGRI PERMIT,0,1,1,0,0,
611,Wendell,2021,BUILDING/LOCATION CHECK,204,1,205,0,1.86,
612,Wendell,2021,CHIMNEY FIRE,0,3,3,13.56,72.52,
613,Wendell,2021,CHECK WELFARE,1,10,11,19.23,15.24,
614,Wendell,2021,CRUISER MAINTENANCE,2,0,2,0,32.07,
615,Wendell,2021,CARBON MONOXIDE HAZARD,0,3,3,0,0,
616,Wendell,2021,COMMUNITY POLICING,6,2,8,0,6.23,
617,Wendell,2021,COMPLAINT,2,5,7,11.68,0.08,
618,Wendell,2021,DISTURBANCE,0,4,4,16.83,76.72,
619,Wendell,2021,DISABLED MV,5,8,13,23.67,10.63,
620,Wendell,2021,DOMESTIC,0,2,2,15.33,68.12,
621,Wendell,2021,DETAIL REQUEST,0,4,4,0,0,
622,Wendell,2021,ESCORT/TRANSPORT,1,3,4,32.23,12.07,
623,Wendell,2021,FIREARMS LICENSING,9,0,9,0,2.74,
624,Wendell,2021,BRUSH FIRE,0,4,4,18.3,28.65,
625,Wendell,2021,STRUCTURE FIRE,0,1,1,9.43,79.32,
626,Wendell,2021,"FIRE, OTHER NON-SPECIFIC",0,2,2,19.23,33.17,
627,Wendell,2021,VEHICLE FIRE,0,1,1,0,0,
628,Wendell,2021,FIRE WORKS,0,1,1,0,0,
629,Wendell,2021,FOLLOW UP INVESTIGATION,6,4,10,0,13.33,
630,Wendell,2021,FRAUD/SCAM,0,4,4,0,0,
631,Wendell,2021,GENERAL INFO,0,4,4,0,0,
632,Wendell,2021,HARASSMENT,1,1,2,0,5.62,
633,Wendell,2021,ILLEGAL BURN,0,2,2,0,0,
634,Wendell,2021,INVESTIGATION,5,1,6,0,17.05,
635,Wendell,2021,LARCENY,0,1,1,0.52,17.02,
636,Wendell,2021,LINE DOWN POWER PHONE OR CABL,1,8,9,12.52,38.22,
637,Wendell,2021,MEDICAL EMERGENCY,0,51,51,14.05,21.83,
638,Wendell,2021,MISSING PERSON,0,2,2,11.7,36.75,
639,Wendell,2021,MISCELLANEOUS,4,6,10,0,16.86,
640,Wendell,2021,MOTOR VEHICLE ACCIDENT NO INJU,0,9,9,18,50.34,
641,Wendell,2021,MOTOR VEHICLE COMPLAINT,5,7,12,28.52,18.95,
642,Wendell,2021,MOTOR VEHICLE ACCIDENT W/INJURY,0,2,2,23.24,41.65,
643,Wendell,2021,MOTOR VEHICLE VIOLATION,34,0,34,0,8.65,
644,Wendell,2021,NOISE COMPLAINT,1,18,19,18.8,24.12,
645,Wendell,2021,NOTIFICATION,0,5,5,23.2,0.05,
646,Wendell,2021,OFFICER WANTED,0,8,8,18.48,29.02,
647,Wendell,2021,PAPERWORK SERVICE,25,2,27,17.96,6.07,
648,Wendell,2021,PARKING COMPLAINT,2,0,2,0,5.49,
649,Wendell,2021,PATROL AREA,8,0,8,0,0,
650,Wendell,2021,RADAR/TRAFFIC ENFORCEMENT,94,1,95,0.57,33.26,
651,Wendell,2021,ROLLING 9,0,2,2,0,0,
652,Wendell,2021,SAFETY HAZARD,0,6,6,3.25,8.22,
653,Wendell,2021,SHOTS FIRED,0,1,1,25.35,25.15,
654,Wendell,2021,SMOKE INVESTIGATION,0,1,1,0,0,
655,Wendell,2021,SOLICITING,0,1,1,0,0,
656,Wendell,2021,SUSPICIOUS PERSON,0,2,2,15.66,28.22,
657,Wendell,2021,SUSPICIOUS ACTIVITY,0,4,4,4.52,4.8,
658,Wendell,2021,SUICIDE THREAT,0,1,1,0.05,77.82,
659,Wendell,2021,SUSPICIOUS VEHICLE,0,4,4,16.61,5.34,
660,Wendell,2021,THREAT,0,1,1,0,0,
661,Wendell,2021,TRAFFIC HAZARD,6,7,13,6.99,21.22,
662,Wendell,2021,TRAFFIC CONTROL,5,0,5,0.05,23.39,
663,Wendell,2021,TRESPASS,2,2,4,15.34,23.55,
664,Wendell,2021,TRUANT,0,1,1,0,0,
665,Wendell,2021,VANDALISM,3,1,4,2.87,7.17,
666,Wendell,2021,SERVE WARRANT,3,1,4,5.64,14.95,
668,Wendell,2022,209A VIOLATION,0,1,1,0,0,
673,Wendell,2022,ABANDONED MV,2,2,4,0,16.31,
674,Wendell,2022,ADMINISTRATIVE,3,0,3,0,91.28,
681,Wendell,2022,ASSAULT,0,2,2,0,0,
682,Wendell,2022,ARTICLES LOST,1,0,1,0,10.3,
683,Wendell,2022,ARTICLES RECOVERED,1,1,2,0,0.83,
685,Wendell,2022,BURN/AGRI PERMIT,0,1,1,0,0,
686,Wendell,2022,BUILDING/LOCATION CHECK,324,0,324,0,3.35,
688,Wendell,2022,Civil Issue,0,1,1,0,0,
689,Wendell,2022,CARBON MONOXIDE HAZARD,0,1,1,0,0,
690,Wendell,2022,COMMUNITY POLICING,29,2,31,0,25.71,
691,Wendell,2022,COMPLAINT,0,1,1,0,0,
697,Wendell,2022,DRUG OFFENSE,0,1,1,0,0,
698,Wendell,2022,DETAIL REQUEST,0,2,2,0,0,
700,Wendell,2022,BRUSH FIRE,0,5,5,0,0,
701,Wendell,2022,"FIRE, OTHER NON-SPECIFIC",0,2,2,0,0,
704,Wendell,2022,FRAUD/SCAM,1,0,1,0,0,
705,Wendell,2022,GENERAL INFO,1,12,13,0,0,
711,Wendell,2022,LOCKOUT,0,1,1,0,0,
714,Wendell,2022,MISCELLANEOUS,0,2,2,0,0,
719,Wendell,2022,NOISE COMPLAINT,0,3,3,0,0,
723,Wendell,2022,PATROL AREA,34,0,34,0,41.2,
734,Wendell,2022,SUSPICIOUS PACKAGE,1,0,1,0,0,
739,Wendell,2022,TRAFFIC CONTROL,1,0,1,0,56.28,
708,Wendell,2022,INVESTIGATION,4,0,4,0.03,29.34,
669,Wendell,2022,ABANDONED 911 CALL,0,3,3,0.05,3.13,
724,Wendell,2022,RADAR/TRAFFIC ENFORCEMENT,59,1,60,0.22,36.15,
731,Wendell,2022,SOLICITING,0,1,1,1.05,0.7,
728,Wendell,2022,Section 12,0,1,1,1.21,13.43,
725,Wendell,2022,RESCUE CALL,0,1,1,1.3,94.92,
727,Wendell,2022,SEARCH,0,1,1,2.38,8.06,
730,Wendell,2022,SMOKE INVESTIGATION,0,1,1,3.73,21.45,
740,Wendell,2022,TRESPASS,0,2,2,5.87,15.02,
684,Wendell,2022,BREAKING AND ENTERING,0,1,1,5.89,19.59,
718,Wendell,2022,MOTOR VEHICLE VIOLATION,12,1,13,6.11,,
699,Wendell,2022,FIREARMS LICENSING,12,4,16,7.95,3.25,
707,Wendell,2022,ILLEGAL DUMPING,0,3,3,9.95,13.06,
676,Wendell,2022,EMS ALARM - LIFELINE ACTIVATED,0,6,6,9.97,30.71,
694,Wendell,2022,DISTURBANCE,0,2,2,11.9,51.62,
738,Wendell,2022,TRAFFIC HAZARD,5,10,15,12.25,15.05,
717,Wendell,2022,MOTOR VEHICLE ACCIDE W/INJURY,0,1,1,12.53,5.47,
715,Wendell,2022,MOTOR VEHICLE ACCIDENT NO INJU,0,12,12,12.74,41.99,
710,Wendell,2022,"LINE DOWN, POWER, PHONE OR CABL",0,6,6,13.19,101.87,
695,Wendell,2022,DISABLED MV,2,9,11,13.58,48.52,
712,Wendell,2022,MEDICAL EMERGENCY,0,61,61,14.56,28.78,
677,Wendell,2022,FIRE ALARM,0,8,8,15.06,16.4,
687,Wendell,2022,CHECK WELFARE,6,19,25,15.12,27.06,
696,Wendell,2022,DOMESTIC,1,1,2,15.49,153.65,
729,Wendell,2022,SERVICE CALL,0,2,2,16.03,18.68,
716,Wendell,2022,MOTOR VEHICLE COMPLAINT,4,8,12,16.82,14.25,
722,Wendell,2022,PAPERWORK SERVICE,20,1,21,16.88,5.62,
733,Wendell,2022,SUSPICIOUS PERSON,0,2,2,16.97,10.68,
703,Wendell,2022,FOLLOW UP INVESTIGATION,18,7,25,3.43,17.35,
732,Wendell,2022,SUMMONS SERVICE,0,1,1,17.68,5.85,
721,Wendell,2022,OFFICER WANTED,1,15,16,17.95,53.73,
667,Wendell,2022,209A SERVICE,1,2,3,18.03,20,
678,Wendell,2022,ANIMAL COMPLAINT,1,32,33,18.05,12.67,
735,Wendell,2022,SUSPICIOUS ACTIVITY,0,6,6,18.44,12.08,
670,Wendell,2022,911 CALL,0,10,10,18.58,4.03,
713,Wendell,2022,MISSING PERSON,0,2,2,18.91,108.98,
679,Wendell,2022,ASSIST CITIZEN,8,9,17,19.36,8.66,
672,Wendell,2022,911 MIS DIAL,0,5,5,20.51,3.28,
702,Wendell,2022,VEHICLE FIRE,0,1,1,21.15,3.8,
737,Wendell,2022,SUSPICIOUS VEHICLE,5,3,8,21.16,3.64,
709,Wendell,2022,LARCENY,1,2,3,22.19,27.47,
693,Wendell,2022,Car vs. Deer,0,3,3,23.27,13.15,
675,Wendell,2022,ALARM BURGLAR OR HOLDUP,0,9,9,24.48,6.25,
706,Wendell,2022,HARASSMENT,0,3,3,25.63,46.57,
680,Wendell,2022,ASSIST OTHER AGENCY,5,7,12,25.73,7.41,
671,Wendell,2022,911 HANG UP,0,2,2,28.38,0.03,
741,Wendell,2022,UNWANTED PERSON,0,1,1,28.72,78.38,
736,Wendell,2022,SUICIDE THREAT,0,2,2,28.96,91.67,
726,Wendell,2022,SAFETY HAZARD,0,5,5,28.98,12.07,
742,Wendell,2022,SERVE WARRANT,2,1,3,38.83,3.76,
720,Wendell,2022,NOTIFICATION,1,9,10,46.17,13.47,
692,Wendell,2022,CSO FOLLOW UP,3,0,3,10.58,48.36,Avg._Arrive on source PDF = 33333.33. I changed to avg for the year = 10.58
